一简对多繁
http://www.qqxiuzi.cn/wz/jiantizi-fantizi/226.htm
简繁转换一简对多繁列表，最少两个最多五个
一简对二繁
启→啓啟
板→板闆
杯→杯盃
辟→辟闢
表→表錶
别→別彆
卜→卜蔔
布→布佈
才→才纔
彩→彩綵
参→參蔘
冲→沖衝
虫→虫蟲
丑→丑醜
仇→仇讎
出→出齣
村→村邨
粗→粗麤
酬→酬醻
当→當噹
党→黨党
淀→澱淀
吊→弔吊
冬→冬鼕
发→發髮
范→范範
丰→豐丰
谷→谷穀
雇→雇僱
刮→刮颳
广→廣广
哄→哄鬨
后→後后
伙→夥伙
获→獲穫
几→幾几
饥→飢饑
迹→跡蹟
奸→奸姦
姜→姜薑
借→借藉
尽→盡儘
据→據据
卷→捲卷
克→克剋
困→困睏
夸→夸誇
罗→羅囉
累→累纍
厘→厘釐
漓→漓灕
梁→梁樑
了→了瞭
霉→霉黴
弥→彌瀰
蔑→蔑衊
么→么麼
麽→麽麼
苹→蘋苹
仆→僕仆
铺→鋪舖
朴→朴樸
签→簽籤
确→確确
舍→舍捨
沈→沈瀋
胜→勝胜
术→術朮
松→松鬆
它→它牠
他→他祂
叹→嘆歎
坛→壇罈
体→體体
同→同衕
涂→涂塗
团→團糰
喂→喂餵
为→為爲
纤→纖縴
咸→鹹咸
弦→弦絃
绣→綉繡
须→須鬚
熏→熏燻
腌→醃腌
叶→葉叶
佣→傭佣
涌→湧涌
游→游遊
于→於于
余→余餘
吁→籲吁
郁→郁鬱
欲→欲慾
御→御禦
愿→願愿
岳→岳嶽
云→雲云
赞→贊讚
脏→臟髒
扎→扎紮
占→占佔
折→折摺
征→征徵
证→證証
志→志誌
制→制製
致→致緻
钟→鍾鐘
种→種种
周→周週
注→註注
准→準准
冢→塚冢
庄→庄莊
涩→澀澁
蚕→蠶蚕
忏→懺忏
吨→噸吨
赶→趕赶
构→構构
柜→櫃柜
怀→懷怀
坏→壞坏
极→極极
茧→繭茧
家→家傢
价→價价
洁→潔洁
惊→驚惊
腊→臘腊
蜡→蠟蜡
帘→簾帘
怜→憐怜
岭→嶺岭
扑→撲扑
秋→秋鞦
千→千韆
确→確确
扰→擾扰
洒→灑洒
晒→曬晒
适→適适
听→聽听
洼→窪洼
网→網网
旋→旋鏇
踊→踴踊
优→優优
症→症癥
朱→朱硃
荐→薦荐
离→離离
卤→鹵滷
气→氣气
圣→聖圣
万→萬万
与→與与
摆→擺襬
虮→蟣虮
篱→籬篱
泞→濘泞
恶→惡噁
托→托託
杰→杰傑
昆→昆崑
戚→戚慼
仑→侖崙
夭→夭殀
毋→毋毌
奶→奶嬭
圬→圬杇
床→床牀
儿→兒儿
拈→拈撚
硅→矽硅
虬→虯虬
咱→咱偺
炫→炫衒
个→個箇
娘→娘孃
殷→殷慇
啖→啖啗
执→執执
庵→庵菴
强→強彊
彗→彗篲
挂→掛挂
栖→棲栖
答→答荅
闲→閒閑
坞→塢隖
盏→盞醆
碰→碰踫
绦→絛縚
埙→塤壎
宁→寧甯
枪→槍鎗
衔→銜啣
铣→銑鐉
驳→駁駮
札→劄札
僵→僵殭
嘻→嘻譆
幢→幢橦
幡→幡旛
盘→盤槃
锉→銼剉
鸩→鴆酖
噪→噪譟
担→擔担
筑→築筑
恹→懨懕
鲧→鯀鮌
懒→懶嬾
檐→簷檐
膻→羶膻
藤→藤籐
铲→鏟剷
韵→韻韵
垆→壚罏
鳅→鰍鰌
馈→饋餽
鳀→鯷鮷
铁→鐵銕
坝→壩垻
钥→鑰鈅
钻→鑽鉆
乃→乃迺
寸→寸吋
凶→凶兇
夫→夫伕
尺→尺呎
仿→仿倣
合→合閤
吃→吃喫
圭→圭珪
扣→扣釦
助→助耡
呆→呆獃
杠→杠槓
灶→灶竈
沄→沄澐
匡→劻匡
幸→幸倖
念→念唸
抬→抬擡
泄→泄洩
肴→肴餚
芸→芸蕓
虱→虱蝨
剃→剃薙
咽→咽嚥
咯→咯詻
尸→屍尸
背→背揹
啕→咷啕
凌→凌淩
唉→唉欸
唇→唇脣
席→席蓆
捂→捂摀
挽→挽輓
效→效傚
核→核覈
栗→栗慄
浩→浩澔
疱→皰疱
秘→秘祕
胁→脅脇
针→針鍼
纴→紝絍
匾→匾楄
从→從从
凄→淒悽
焊→焊銲
琅→琅瑯
瓶→瓶缾
众→眾衆
眯→眯瞇
剩→剩賸
勋→勛勳
喧→喧諠
棹→棹櫂
勤→勤懃
愈→愈癒
搜→搜蒐
暗→暗闇
溪→溪谿
烟→煙菸
炼→煉鍊
痴→痴癡
逾→逾踰
愧→媿愧
棰→棰箠
药→葯藥
演→演縯
蓑→蓑簑
酸→酸痠
剑→劍劒
哗→嘩譁
璇→璇璿
瘘→瘺瘻
谥→諡謚
荡→盪蕩
糟→糟蹧
檩→檁檩
宁→寧宁
苧→薴苧
蝎→蠍蝎
棂→櫺欞
鉴→鑑鑒
罐→罐鑵
玱→玱瑲
疴→疴痾
缰→繮韁
莼→蒓蓴
鹚→鷀鶿
凭→憑凭
缽→缽鉢
象→象像

一简对三繁
曲→曲麯麴
升→升昇陞
苏→蘇囌甦
系→系係繫
尝→嘗甞嚐
胡→胡鬍衚
划→畫劃划
回→回迴囘
汇→匯彙滙
里→里裡裏
历→歷曆厤
袅→裊嫋嬝
线→缐線綫
向→向嚮曏
只→只隻衹
刨→刨鉋鑤
抵→抵牴觝
崎→崎埼碕
麻→麻痲蔴
攒→攢儹欑
岩→岩巖嵒
炮→炮砲礮
棱→棱稜崚
呼→呼虖謼
泛→泛氾汎
宴→宴讌醼
捆→捆綑梱
毁→毀燬譭
鼗→鞀鞉鼗
橹→櫓艣艪
鹇→鷴鷳鷼
欢→歡懽讙

一简对四繁
并→并並併竝
采→采埰寀採
厂→厂庵厰廠
干→乾干幹榦
蒙→蒙懞濛矇
面→面麵麪麫
复→復複覆复
局→局侷挶跼
雕→雕鵰彫琱

一简对五繁
斗→鬥斗鬪鬦鬭
台→臺台檯枱颱


